{
  "defaultPrice": 0,
  "prices": {
    "黃銅": 300,
    "銘牌": 300,
    "麻繩": 150,
    "皮革": 450,
    "掛帶": 450,
    "吊牌": 250,
    "吊飾": 200,
    "托架": 350,
    "支架": 380
  }
}
